#######################################
# Syntax Coloring Map For SerialModbus
#######################################

#######################################
# Datatypes (KEYWORD1)
#######################################

SerialModbusClient	KEYWORD1
SerialModbusServer	KEYWORD1

MB_FunctionCode_t	KEYWORD1
MB_SubFunctionCode_t	KEYWORD1
MB_Exception_t	KEYWORD1
MB_Status_t	KEYWORD1

MB_Request_t	KEYWORD1

MB_Access_t	KEYWORD1
MB_Register_t	KEYWORD1

#######################################
# Methods and Functions (KEYWORD2)
#######################################

begin	KEYWORD2
setSerialCtrl	KEYWORD2
setProcessLoopHook	KEYWORD2
setCustomDelay	KEYWORD2
getExceptionString	KEYWORD2
getInterCharacterTimeout	KEYWORD2
getInterFrameDelay	KEYWORD2
setInterCharacterTimeout	KEYWORD2
setInterFrameDelay	KEYWORD2

setRequestMap	KEYWORD2
setRequest	KEYWORD2
process	KEYWORD2
getResponseTimeout	KEYWORD2
getTurnaroundDelay	KEYWORD2
setResponseTimeout	KEYWORD2
setTurnaroundDelay	KEYWORD2

sendRequest	KEYWORD2
readHoldingRegister	KEYWORD2
readInputRegister	KEYWORD2
writeSingleCoil	KEYWORD2
writeSingleRegister	KEYWORD2
getLastException	KEYWORD2
getLastExceptionString	KEYWORD2

setRegisterMap	KEYWORD2
checkRegisterMap	KEYWORD2

diagRegGet	KEYWORD2
diagRegGet	KEYWORD2
diagRegSet	KEYWORD2
diagRegClear	KEYWORD2

createRegister	KEYWORD2
createCoils	KEYWORD2
createInputResgisters	KEYWORD2
createHoldingRegisters	KEYWORD2
getCoil	KEYWORD2
getInputResgister	KEYWORD2
getHoldingRegister	KEYWORD2
setCoil	KEYWORD2
setInputResgister	KEYWORD2
setHoldingRegister	KEYWORD2

#######################################
# Constants (LITERAL1)
#######################################

FC_READ_COILS	LITERAL1
FC_READ_DISCRETE_INPUTS	LITERAL1
FC_WRITE_SINGLE_COIL	LITERAL1
FC_WRITE_MULTIPLE_COILS	LITERAL1
FC_READ_HOLDING_REGISTERS	LITERAL1
FC_READ_INPUT_REGISTERS	LITERAL1
FC_WRITE_SINGLE_REGISTER	LITERAL1
FC_WRITE_MULTIPLE_REGISTERS	LITERAL1
FC_MASK_WRITE_REGISTER	LITERAL1
FC_READ_WRITE_MULTIPLE_REGISTERS	LITERAL1
FC_READ_FIFO_QUEUE	LITERAL1
FC_READ_FILE_RECORD	LITERAL1
FC_WRITE_FILE_RECORD	LITERAL1
FC_READ_EXCEPTION_STATUS	LITERAL1
FC_DIAGNOSTIC	LITERAL1
FC_GET_COM_EVENT_COUNTER	LITERAL1
FC_GET_COM_EVENT_LOG	LITERAL1
FC_REPORT_SERVER_ID	LITERAL1

SFC_RETURN_QUERY_DATA	LITERAL1
SFC_RESTART_COMMUNICATIONS_OPTION	LITERAL1
SFC_RETURN_DIAGNOSTIC_REGISTER	LITERAL1
SFC_CHANGE_ASCII_INPUT_DELIMITER	LITERAL1
SFC_FORCE_LISTEN_ONLY_MODE	LITERAL1
SFC_CLEAR_COUNTERS_AND_DIAGNOSTIC_REGISTER	LITERAL1
SFC_RETURN_BUS_MESSAGE_COUNT	LITERAL1
SFC_RETURN_BUS_COMMUNICATION_ERROR_COUNT	LITERAL1
SFC_RETURN_BUS_EXCEPTION_ERROR_COUNT	LITERAL1
SFC_RETURN_SERVER_MESSAGE_COUNT	LITERAL1
SFC_RETURN_SERVER_NO_RESPONSE_COUNT	LITERAL1
SFC_RETURN_SERVER_NAK_COUNT	LITERAL1
SFC_RETURN_SERVER_BUSY_COUNT	LITERAL1
SFC_RETURN_BUS_CHARACTER_OVERRUN_COUNT	LITERAL1
SFC_CLEAR_OVERRUN_COUNTER_AND_FLAG	LITERAL1

MB_OK	LITERAL1
MB_ILLEGAL_FUNCTION	LITERAL1
MB_ILLEGAL_DATA_ADDRESS	LITERAL1
MB_ILLEGAL_DATA_VALUE	LITERAL1
MB_SERVER_DEVICE_FAILURE	LITERAL1
MB_ACKNOWLEDGE	LITERAL1
MB_SERVER_DEVICE_BUSY	LITERAL1
MB_MEMORY_PARITY_ERROR	LITERAL1
MB_GATEWAY_PATH_UNAVAILABLE	LITERAL1
MB_GATEWAY_TARGET_DEVICE_FAILED_TO_RESPOND	LITERAL1
MB_ILLEGAL_REQUEST	LITERAL1
MB_CHARACTER_OVERRUN	LITERAL1
MB_NO_REPLY	LITERAL1
MB_ILLEGAL_CHECKSUM	LITERAL1
MB_ILLEGAL_STATE	LITERAL1
MB_ILLEGAL_BYTE_COUNT	LITERAL1
MB_ILLEGAL_COIL_VALUE	LITERAL1
MB_ILLEGAL_OUTPUT_ADDRESS	LITERAL1
MB_ILLEGAL_OUTPUT_VALUE	LITERAL1
MB_ILLEGAL_QUANTITY	LITERAL1
MB_ILLEGAL_QUERY_DATA	LITERAL1
MB_ILLEGAL_SUB_FUNCTION	LITERAL1
MB_ILLEGAL_REPLY_SUB_FUNCTION	LITERAL1
MB_SERVER_ILLEGAL_FUNCTION	LITERAL1
MB_SERVER_ILLEGAL_STATE	LITERAL1
MB_SERVER_ILLEGAL_ACCESS	LITERAL1
MB_SERVER_ILLEGAL_QUANTITY	LITERAL1
MB_SERVER_ILLEGAL_COIL_VALUE	LITERAL1
MB_SERVER_ILLEGAL_INPUT_DELIMITER	LITERAL1
MB_SERVER_ILLEGAL_SUB_FUNCTION	LITERAL1
MB_NOK	LITERAL1

MB_COIL_ON	LITERAL1
MB_COIL_OFF	LITERAL1
MB_CLEAR_COM_EVENT_LOG	LITERAL1

MB_REQUEST_MAP_END	LITERAL1

MB_NA	LITERAL1
MB_RD	LITERAL1
MB_WR	LITERAL1
MB_RW	LITERAL1

MB_REGISTER_MAP_END	LITERAL1
